1111111111
1000000001
1000000001
1011110001
1001000111
1101110001
1000x000x1
1110001001
1000001001
1100001x01
1001001001
1001111101
110x011001
110$110001
1111111111
